Adam	Adama	Adame	m	24	12
Adámek	Adámka	Adámku	m	24	12
Áda	Ádu	Ádo	m	24	12
Adéla	Adélu	Adélo	f	2	9
Adélka	Adélku	Adélko	f	2	9
Ady	Ady	Ady	f	2	9
Áda	Ádu	Ádo	f	2	9
Áïa	Áïu	Áïo	f	2	9
Adolf	Adolfa	Adolfe	m	17	6
Adina	Adinu	Adino	f	17	6
Adrian	Adriana	Adriane	m	26	6
Adriana	Adrianu	Adriano	f	26	6
Adri	Adri	Adri	f	26	6
Adrianka	Adrianku	Adrianko	f	26	6
Agáta	Agátu	Agáto	f	14	10
Agátka	Agátku	Agátko	f	14	10
Agi	Agi	Agi	f	14	10
Alan	Alana	Alane	m	14	8
Alánek	Alánka	Alánku	m	14	8
Alda	Aldu	Aldo	m	14	8
Albín	Albína	Albíne	m	1	3
Albík	Albíka	Albíku	m	1	3
Albi	Albiho	Albi	m	1	3
Albína	Albínu	Albíno	f	14	12
Albínka	Albínku	Albínko	f	14	12
Albi	Albi	Albi	f	14	12
Alena	Alenu	Aleno	f	13	8
Alenka	Alenku	Alenko	f	13	8
Alèa	Alèu	Alèo	f	13	8
Ála	Álu	Álo	f	13	8
Aleš	Aleše	Aleši	m	13	4
Alda	Aldu	Aldo	m	13	4
Alexandra	Alexandru	Alexandro	f	21	4
Alex	Alex	Alex	f	21	4
Saša	Sašu	Sašo	f	21	4
Alexandr	Alexandra	Alexandøe	m	27	2
Alex	Alexe	Alexi	m	27	2
Saša	Sašu	Sašo	¨m	27	2
Alexia	Alexii	Alexie	f	3	5
Alois	Aloise	m
Lojza	Lojzu	m
Lojzík	Lojzíka	m
Aloisie	Aloisii	f
Lujzièka	Lujzièku	f
Lojzièka	Lojzièku	f
Lojzek	Lojzka	m
Albert	Alberta	m
Alberta	Albertu	f
Albìta	Albìtu	f
Albìtka	Albìtku	f
Bìta	Bìtu	f
Bìtka	Bìtku	f
Bìtuška	Bìtušku	f
Bìtuš	Bìtuš	f
Amálie	Amálii	f
Amálka	Amálku	f
Anastázie	Anastázii	f
Stázka	Stázku	f
Andrea	Andreu	f
Andrejka	Andrejku	f
Andy	Andy	f
Andrej	Andreje	m
Andy	Andyho	m
Aneka	Aneku	f
Áòa	Áòu	f
Anna	Annu	f
Anièka	Anièku	f
Anèa	Anèu	f
Annie	Annie	f
Anka	Anku	f
Aneta	Anetu	f
Anetka	Anetku	f
Anet	Anet	f
Antonín	Antonína	m
Toník	Toníka	m
Tonda	Tondu	m
Tony	Tonyho	m
Antonie	Antonii	f
Tonièka	Tonièku	f
Tonka	Tonku	f
Tonèa	Tonèu	f
Tóòa	Tóòu	f
Arnošt	Arnošta	m
Arnie	Arnieho	m
Arnoštka	Arnoštku	f
Arpád	Arpáda	m
Artur	Artura	m
Art	Arta	m
Arty	Artyho	m
Augustın	Augustına	m
Gusta	Gustu	b
Augustına	Augustınu	f
Baltazar	Baltazara	m
Barbora	Barboru	f
Barborka	Barborku	f
Bára	Báru	f
Barèa	Barèu	f
Baruš	Baruš	f
Baruška	Barušku	f
Barnabáš	Barnabáše	m
Bartolomìj	Bartolomìje	m
Barty	Bartyho	m
Beáta	Beátu	f
Beátka	Beátku	f
Bea	Beu	f
Bedøich	Bedøicha	m
Béda	Bédu	m
Béïa	Béïu	b
Bedøiška	Bedøišku	f
Bìla	Bìlu	f
Bìlka	Bìlku	f
Benedikt	¨Benedikta	m
Bernard	Bernarda	m
Bert	Berta	m
Berta	Bertu	f
Blahoslav	Blahoslava	m
Blahoš	Blahoše	m
Blanka	Blanku	f
Bláòa	Bláòu	f
Blanièka	Blanièku	f
Blaej	Blaeje	m
Blaena	Blaenu	f
Bláa	Bláu	b
Blaenka	Blaenku	f
Blaka	Blaku	f
Blaek	Blaka	m
Bohdan	Bohdana	m
Bohdana	Bohdanu	f
Bohdanka	Bohdanku	f
Bohumil	Bohumila	m
Bohumila	Bohumilu	f
Bohuslav	Bohuslava	m
Bohuslava	Bohuslavu	f
Bohouš	Bohouše	m
Bohoušek	Bohouška	m
Bohuš	Bohuše	m
Bohuna	Bohunu	f
Bohunka	Bohunku	f
Boleslav	Boleslava	m
Bolek	Bolka	m
Bonifác	Bonifáce	m
Boris	Borise	m
Boøek	Boøka	m
Boøivoj	Boøivoje	m
Boena	Boenu	f
Boenka	Boenku	f
Boka	Boku	f
Branislav	Branislava	m
Branislava	Branislavu	f
Bronislav	Bronislava	m
Bronislava	Bronislavu	f
Broòa	Broòu	b
Bróòa	Bróòu	b
Brano	Brana	m
Braòo	Braòa	m
Bruno	Bruna	m
Bøetislav	Bøetislava	m
Bøetislava	Bøetislavu	f
Bøéa	Bøéu	b
Cecílie	Cecílii	f
Cecilka	Cecilku	f
Cilka	Cilku	f
Ctibor	Ctibora	m
Borek	Borka	m
Ctirad	Ctirada	m
Cyril	Cyrila	m
Cyrila	Cyrilu	f
Cyrda	Cyrdu	b
Èenìk	Èeòka	m
Èestmír	Èestmíra	m
Dalibor	Dalibora	m
Dalík	Dalíka	m
Dali	Daliho	m
Dalimil	Dalimila	m
Dana	Danu	f
Danka	Danku	f
Danèa	Danèu	f
Danuše	Danuši	f
Danuška	Danušku	f
Daniel	Daniela	m
Daniela	Danielu	f
Danielka	Danielku	f
Dan	Dana	m
Dany	Danyho	m
Darek	Darka	m
Derek	Dereka	m
Darina	Darinu	f
Darinka	Darinku	f
Dagmar	Dagmar	f
Dáša	Dášu	f
David	Davida	m
Dave	Davea	m
Davi	Daviho	m
Debora	Deboru	f
Denis	Denise	m
Denisa	Denisu	f
Deniska	Denisku	f
Denda	Dendu	f
Denèa	Denèu	f
Diana	Dianu	f
Dita	Ditu	f
Dobroslav	Dobroslava	m
Dominik	Dominika	m
Dominika	Dominiku	f
Domèa	Domèu	b
Dorota	Dorotku	f
Dorka	Dorku	f
Doubravka	Doubravku	f
Drahomír	Drahomíra	m
Drahoš	Drahoše	m
Drahomíra	Drahomíru	f
Drahuše	Drahuši	f
Drahuška	Drahušku	f
Drahoslav	Drahoslava	m
Drahoslava	Drahoslavu	f
Dušan	Dušana	m
Dušana	Dušanu	f
Edita	Editu	f
Edi	Edi	f
Editka	Editku	f
Eduard	Eduarda	m
Eda	Edu	m
Eddie	Eddieho	m
Egon	Egona	m
Eliáš	Eliáše	m
Eliška	Elišku	f
Eli	Eli	f
Ela	Elu	f
Elen	Elen	f
Elenka	Elenku	f
Elèa	Elèu	f
Elvíra	Elvíru	f
Elvírka	Elvírku	f
Emanuel	Emanuela	m
Emanuela	Emanuelu	f
Emil	Emila	m
Emílie	Emílii	f
Emilka	Emilku	f
Erik	Erika	m
Erika	Eriku	f
Ervín	Ervína	m
Ester	Ester	f
Esterka	Esterku	f
Eva	Evu	f
Evka	Evku	f
Evièka	Evièku	f
Evèa	Evèu	f
Even	Evena	m
Evenie	Evenii	f
Fabián	Fabiána	m
Felix	Felixe	m
Ferdinand	Ferdinanda	m
Ferda	Ferdu	m
Filip	Filipa	m
Fíla	Fílu	m
Filda	Fildu	m
Florian	Floriana	m
František	Františka	m
Františka	Františku	f
Franta	Frantu	b
Fráòa	Fráòu	b
Fanda	Fandu	m
Fany	Fany	f
Fanèa	Fanèu	f
Fáòa	Fáòu	f
Fanka	Fanku	f
Fanouš	Fanouše	m
Gabriel	Gabriela	m
Gabi	Gabiho	m
Gábi	Gábi	f
Gábina	Gábinu	f
Gabèa	Gabèu	f
Gabriela	Gabrielu	f
Gita	Gitu	f
Gustav	Gustava	m
Hana	Hanu	f
Hanka	Hanku	f
Hanièka	Hanièku	f
Hanèa	Hanèu	f
Háòa	Háòu	f
Helena	Helenu	f
Helèa	Helèu	f
Hela	Helu	f
Helenka	Helenku	f
Heli	Heli	f
Heøman	Heømana	m
Horymír	Horymíra	m
Hugo	Huga	m
Hynek	Hynka	m
Igor	Igora	m
Ilona	Ilona	f
Ilonka	Ilonku	f
Ilèa	Ilèu	f
Ilja	Ilju	b
Ingrid	Ingrid	f
Irena	Irenu	f
Irèa	Irèu	f
Irenka	Irenku	f
Irma	Irmu	f
Iva	Ivu	f
Ivèa	Ivèu	f
Ivan	Ivana	m
Ivánek	Ivánka	m
Ivoš	Ivoše	m
Ivana	Ivanu	f
Ivanka	Ivanku	f
Ivo	Iva	m
Ivona	Ivonu	f
Ivonka	Ivonku	f
Izabela	Izabelu	f
Bela	Belu	f
Izi	Izi	f
Jáchym	Jáchyma	m
Jakub	Jakuba	m
Kuba	Kubu	m
Kubík	Kubíka	m
Kubíèek	Kubíèka	m
Jan	Jana	m
Honza	Honzu	m
Jenda	Jendu	m
Jeník	Jeníka	m
Jeníèek	Jeníèka	m
Jana	Janu	f
Janièka	Janièku	f
Janèa	Janèu	f
Jarmil	Jarmila	m
Jarmila	Jarmilu	f
Jarmilka	Jarmilku	f
Jaromír	Jaromíra	m
Jarda	Jardu	m
Jarek	Jarka	m
Jarouš	Jarouše	m
Jaroušek	Jarouška	m
Jára	Járu	m
Jaroslav	Jaroslava	m
Jaroslava	Jaroslavu	f
Slávek	Slávka	m
Slávka	Slávku	f
Jarka	Jarku	f
Jarèa	Jarèu	f
Jaruš	Jaruš	f
Jaruška	Jarušku	f
Jasna	Jasnu	f
Jasmína	Jasmína	f
Jasmínka	Jasmínku	f
Jeronım	Jeronıma	m
Jerry	Jerryho	m
Jiøí	Jiøího	m
Jirka	Jirku	m
Jiøík	Jiøíka	m
Jíøa	Jíøu	b
Jiøina	Jiøinu	f
Jiøka	Jiøku	f
Jiøinka	Jiøinku	f
Jitka	Jitku	f
Jituška	Jitušku	f
Jía	Jíu	f
Jity	Jity	f
Johana	Johanu	f
Johanka	Johanku	f
Jonáš	Jonáše	m
Jonda	Jondu	m
Jóna	Jónu	m
Josef	Josefa	m
Pepa	Pepu	m
Pepek	Pepka	m
Pepan	Pepana	m
Join	Joina	m
Joka	Joku	m
Jozefa	Jozefu	f
Jozefka	Jozefku	f
Pepka	Pepku	f
Pepina	Pepinu	f
Pepèa	Pepèu	f
Josefína	Josefínu	f
Josefínka	Josefínku	f
Pepinka	Pepinku	f
Judita	Juditu	f
Judi	Judi	f
Juditka	Juditku	f
Julie	Julii	f
Julèa	Julèu	f
Juli	Juli	f
Julius	Julia	m
Juli	Juliho	m
Julek	Julka	m
Justına	Justınu	f
Justınka	Justınku	f
Kamila	Kamilu	f
Kamilka	Kamilku	f
Kamèa	Kamèu	f
Kamil	Kamila	m
Karel	Karla	m
Kája	Káju	b
Karlík	Karlíka	m
Karlíèek	Karlíèka	m
Karina	Karinu	f
Karin	Karin	f
Karinka	Karinku	f
Karolína	Karolínu	f
Karolínka	Karolínku	f
Karla	Karlu	f
Karlièka	Karlièku	f
Kateøina	Kateøinu	f
Katka	Katku	f
Kaèka	Kaèku	f
Káa	Káu	f
Katuš	Katuš	f
Katuše	Katuši	f
Katuška	Katušku	f
Kašpar	Kašpara	m
Kašpárek	Kašpárka	m
Klaudie	Klaudii	f
Klaudi	Klaudi	f
Klauïa	Klauïu	f
Klára	Kláru	f
Klaruš	Klaruš	f
Klárka	Klárku	f
Klement	Klementa	m
Kristına	Kristınu	f
Kristınka	Kristınku	f
Tına	Tınu	f
Tınka	Tınku	f
Kristy	Kristy	f
Tınuška	Tınušku	f
Kristián	Kristiána	m
Kryštof	Kryštofa	m
Kryštùfek	Kryštùfka	m
Kryšpín	Kryšpína	m
Kvìtoslav	Kvìtoslava	m
Kvìtoslava	Kvìtoslavu	f
Kvìta	Kvìtu	f
Kvìtuše	Kvìtuši	f
Kvìtuš	Kvìtuš	f
Kvìtka	Kvìtku	f
Kvìtuška	Kvìtušku	f
Ladislav	Ladislava	m
Láïa	Láïu	b
Ladislava	Ladislavu	f
Laïka	Laïku	f
Laura	Lauru	f
Lea	Leu	f
Leuška	Leušku	f
Leuš	Leuš	f
Leontına	Leontınu	f
Leontınka	Leontınku	f
Leoš	Leoše	m
Libor	Libora	m
Liborek	Liborka	m
Libuše	Libuši	f
Libuška	Libušku	f
Líba	Líbu	f
Linda	Lindu	f
Lubomír	Lubomíra	m
Luboš	Luboše	m
Lubor	Lubora	m
Luba	Lubu	m
Lubo	Lubu	m
Lubošek	Luboška	m
Lucie	Lucii	f
Lucka	Lucku	f
Lucinka	Lucinku	f
Ludmila	Ludmilu	f
Lída	Lídu	f
Liduška	Lidušku	f
Lidunka	Lidunku	f
Lidka	Lidku	f
Ludvík	Ludvíka	m
Ludva	Ludvu	m
Lujza	Lujzu	f
Lukáš	Lukáše	m
Luky	Lukyho	m
Lukyn	Lukyna	m
Lumír	Lumíra	m
Magdaléna	Magdalénu	f
Magda	Magdu	f
Mája	Máju	f
Madla	Madlu	f
Majda	Majdu	f
Marek	Marka	m
Mára	Máru	m
Mara	Maru	m
Marian	Mariana	m
Mariana	Marianu	f
Marie	Marii	f
Maruška	Marušku	f
Maruš	Maruš	f
Marika	Mariku	f
Mari	Mari	f
Marina	Marinu	f
Maøka	Maøku	f
Maøenka	Maøenku	f
Maøena	Maøenu	f
Máøa	Máøu	b
Markéta	Markétu	f
Markét	Markét	f
Markétka	Markétku	f
Marta	Martu	f
Marcela	Marcelu	f
Marcelka	Marcelku	f
Marcel	Marcela	m
Martin	Martina	m
Mara	Maru	b
Marty	Martyho	m
Maras	Marase	m
Martina	Martinu	f
Martinka	Martinku	f
Matìj	Matìje	m
Mates	Matese	m
Máa	Máu	m
Matouš	Matouše	m
Maxim	Maxima	m
Maxmilián	Maxmiliána	m
Max	Maxe	m
Melanie	Melanii	f
Mel	Mel	f
Melèa	Melèu	f
Meli	Meli	f
Melichar	Melichara	m
Michaela	Michaelu	f
Michal	Michala	m
Michael	Michaela	m
Michala	Michalu	f
Míša	Míšu	b
Miška	Mišku	b
Mikuláš	Mikuláše	m
Milada	Miladu	f
Miládka	Miládku	f
Milan	Milana	m
Milena	Milenu	f
Miloslav	Miloslava	m
Miloslava	Miloslavu	f
Miloš	Miloše	m
Milda	Mildu	b
Míla	Mílu	b
Milouš	Milouše	m
Miluše	Miluši	f
Miluška	Milušku	f
Mirek	Mirka	m
Míra	Míru	m
Miroslav	Miroslava	m
Miroslava	Miroslavu	f
Mirka	Mirku	f
Miri	Miri	f
Miruška	Mirušku	f
Mireèek	Mireèka	m
Mojmír	Mojmíra	m
Monika	Moniku	f
Monèa	Mon¡èu	f
Moni	Moni	f
Móòa	Móòu	f
Monièka	Monièku	f
Nadìda	Nadìdu	f
Naïa	Naïu	f
Natálie	Natálii	f
Naty	Naty	f
Natka	Natku	f
Nela	Nelu	f
Nelka	Nelku	f
Nelèa	Nelèu	f
Nelinka	Nelinku	f
Neluš	Neluš	f
Neluše	Neluši	f
Nikola	Nikolu	f
Nikol	Nikol	f
Nikolka	Nikolku	f
Niki	Niki	f
Nikèa	Nikèu	f
Nikolas	Nikolase	m
Niki	Nikiho	m
Nina	Ninu	f
Nora	Noru	f
Norbert	Norberta	m
Norberta	Norbertu	f
Olga	Olgu	f
Ola	Olu	f
Oli	Oli	f
Olinka	Olinku	f
Olèa	Olèu	f
Oldøich	Oldøicha	m
Olda	Oldu	m
Olívie	Olívii	f
Livi	Livi	f
Ondøej	Ondøeje	m
Ondra	Ondru	m
Oskar	Oskara	m
Otakar	Otakara	m
Otmar	Otmara	m
Oto	Otu	m
Ota	Ota	m
Otík	Otíka	m
Otılie	Otılii	f
Otylka	Otylku	f
Tyli	Tyli	f
Tylka	Tylku	f
Tylèa	Tylèu	f
Pavel	Pavla	m
Pavlík	Pavlíka	m
Pája	Páju	b
Pavla	Pavlu	f
Pavluška	Pavlušku	f
Patrik	Patrika	m
Paa	Pau	b
Páa	Páu	b
Patricie	Patricii	f
Pavlína	Pavlínu	f
Pavlínka	Pavlínku	f
Petr	Petra	m
Pea	Peu	b
Péa	Péu	b
Petruška	Petrušku	f
Peulka	Peulku	b
Peula	Peulu	b
Petra	Petru	f
Ráchel	Ráchel	f
Ráchelka	Ráchelku	f
Radan	Radana	m
Radana	Radanu	f
Radek	Radka	m
Ráïa	Ráïu	b
Rady	Radyho	m
Radko	Radka	m
Radim	Radima	m
Radka	Radku	f
Radoslav	Radoslava	m
Radovan	Radovana	m
Rebeka	Rebeku	f
Beka	Beku	f
Becky	Becky	f
Renata	Renatu	f
Renáta	Renátu	f
Renatka	Renatku	f
Renátka	Renátku	f
René	Reného	m
René	René	f
Renda	Rendu	m
Renèa	Renèu	f
Richard	Richarda	m
Ríša	Ríšu	m
Robert	Roberta	m
Roberta	Robertu	f
Roberto	Roberta	m
Robertek	Robertka	m
Robin	Robina	m
Rob	Roba	m
Bob	Boba	m
Robi	Robiho	m
Robi	Robi	f
Roman	Romana	m
Romèa	Romèu	b
Romouš	Romouše	m
Romana	Romanu	f
Romanka	Romanku	f
Rastislav	Rastislava	m
Rostislav	Rostislava	m
Rasa	Rasu	m
Rosa	Rosu	m
Rozálie	Rozálii	f
Róza	Rózu	f
Rozárka	Rozárku	f
Rózi	Rózi	f
Rudolf	Rudolfa	m
Ruda	Rudu	m
Rudy	Rudyho	m
Rùt	Rùt	f
Rùena	Rùenu	f
Rùa	Rùu	f
Rùenka	Rùenku	f
Sára	Sáru	f
Sáva	Sávu	f
Slavomír	Slavomíra	m
Simon	Simona	m
Simona	Simonu	f
Simonka	Simonku	f
Simi	Simi	f
Simi	Simiho	m
Simèa	Simèu	f
Síma	Símu	b
Sobìslav	Sobìslava	m
Svatava	Svatavu	f
Svaa	Svau	b
Sváa	Sváu	m
Svatopluk	Svatopluka	m
Svatoslav	Svatoslava	m
Šárka	Šárku	f
Sebastian	Sebastiana	m
Sebi	Sebiho	m
Sebík	Sebíka	m
Šimon	Šimona	m
Silvestr	Silvestra	m
Stanislav	Stanislava	m
Stanislava	Stanislavu	f
Standa	Standu	m
Staòo	Staòa	m
Stano	Stana	m
Stáòa	Stáòu	f
Stela	Stelu	f
Šarlota	Šarlotu	f
Šarlot	Šarlot	f
Šarlotka	Šarlotku	f
Loty	Loty	f
Lotynka	Lotynku	f
Lotka	Lotku	f
Lota	Lotu	f
Štìpán	Štìpána	m
Štìpa	Štìpu	b
Štìpi	Štìpiho	m
Štìpi	Štìpi	f
Štìpka	Štìpku	b
Štìpánka	Štìpánku	f
Štefan	Štefana	m
Štefka	Štefku	m
Štefko	Štefka	m
Stefanie	Stefanii	f
Stefi	Stefi	f
Sylvie	Silvii	f
Silva	Silvu	f
Silvinka	Silvinku	f
Sofie	Sofii	f
Sofi	Sofi	f
Sofèa	Sofèu	f
Sofinka	Sofinku	f
Tamara	Tamaru	f
Tami	Tami	f
Tamèa	Tamèu	f
Tereza	Terezu	f
Terka	Terku	f
Terezka	Terezku	f
Teri	Teri	f
Terezie	Terezii	f
Tibor	Tibora	m
Tomáš	Tomáše	m
Tom	Toma	m
Tomík	Tomíka	m
Tomi	Tomiho	m
Tadeáš	Tadeáše	m
Tady	Tadyho	m
Táda	Tádu	m
Taána	Taánu	f
Táòa	Táòu	f
Urban	Urbana	m
Uršula	Uršulu	f
Uršulka	Uršulku	f
Václav	Václava	m
Vašek	Vaška	m
Vašík	Vašíka	m
Venca	Vencu	m
Venda	Vendu	m
Véna	Vénu	m
Venouš	Venouše	m
Venoušek	Venouška	m
Václava	Václavu	f
Václavka	Václavku	f
Vendula	Vendulu	f
Vendulka	Vendulku	f
Vendy	Vendy	f
Valdemar	Valdemara	m
Valda	Valdu	m
Valentın	Valentına	m
Vali	Valiho	m
Vali	Vali	f
Valèa	Valèu	f
Valentına	Valentınu	f
Valerie	Valerii	f
Vanda	Vandu	f
Vendelín	Vendelína	m
Vìra	Vìru	f
Vìrka	Vìrku	f
Vìruš	Vìruš	f
Vìruška	Vìrušku	f
Veronika	Veroniku	f
Verèa	Verèu	f
Veru	Veru	f
Nika	Niku	f
Viktor	Viktora	m
Viki	Vikiho	m
Viki	Viki	f
Viktorka	Viktorku	f
Viktorie	Viktorii	f
Vilém	Viléma	m
Vilda	Vildu	m
Vilèa	Vilèu	m
Vilma	Vilmu	f
Vincenc	Vincence	m
Vincent	Vincenta	m
Vincek	Vincka	m
Viola	Violu	f
Violka	Violku	f
Vít	Víta	m
Vítek	Vítka	m
Vítìzslav	Vítìzslava	m
Vladan	Vladana	m
Vladana	Vladanu	f
Vladimír	Vladimíra	m
Vladimíra	Vladimíru	f
Vláïa	Vláïu	m
Vlaïka	Vlaïku	f
Vlasta	Vlastu	b
Vlastík	Vlastíka	m
Vlastièka	Vlastièku	f
Vlastimil	Vlastimila	m
Vojtìch	Vojtìcha	m
Vojta	Vojtu	m
Vratislav	Vratislava	m
Vráa	Vráu	m
Xaver	Xavera	m
Xavi	Xaviho	m
Xenie	Xenii	f
Xeni	Xeni	f
Xenka	Xenku	f
Zdena	Zdenu	f
Zdenek	Zdenka	m
Zdenìk	Zdeòka	m
Zdenka	Zdenku	f
Zdeòka	Zdeòku	f
Zdenda	Zdendu	m
Zdìnda	Zdìndu	m
Zdenìèek	Zdenìèka	m
Zdenièka	Zdenièku	f
Zdislav	Zdislavu	m
Zdislava	Zdislavu	f
Zdík	Zdíka	m
Zina	Zinu	f
Zinuška	Zinušku	f
Zinajda	Zinajdu	f
Zita	Zitu	f
Zlatan	Zlatana	m
Zlatko	Zlatka	m
Zlatuše	Zlatuši	f
Zlata	Zlatu	f
Zlatka	Zlatku	f
Zlatuš	Zlatuš	f
Zlatuška	Zlatušku	f
Zoe	Zoe	f
Zoja	Zoju	f
Zora	Zoru	f
Zorka	Zorku	f
Zuzana	Zuzanu	f
Zuzka	Zuzku	f
Zuzanka	Zuzanku	f
Zuza	Zuzu	f
Zuzi	Zuzi	f